läbi kaalutlemata - läbikaalutlemata - [['Kahjuks oli Raskolnikovi idee läbikaalutlemata ning naiivne ja mõistagi määratud nurjumisele.']]
kogu aeg - koguaeg - [['Kui koguaeg elada kindlates piirides ei toimukski mingit progressi'], ['Eestlane pole juba oma loomult selline, et koguaeg peab midagi toimuma.'], ['Haridust ja kogemusi omades arendame end koguaeg järjest enam.'], ['Ühiskonnas on palju probleeme, mida koguaeg üritatakse lahendada.'], ['Neid reegleid, käske, keelde, soovitusi tuleb koguaeg juurde, et ei jõuagi kõiki kirja panna.']]
hakkama saamiseks - hakkamasaamiseks - [['Tänu seadustele võime nõuda õiglust, see on andnud meile elus hakkamasaamiseks enam-vähem võrdsed võimalused.']]
tee peal - teepeal - [['Paljud õppisid teepeal, või kohapeal.']]
rüpes - rüppes - [['Loodi igasuguseid organisatsioone ja rõõm oli vaadata, et paljud noored ei jäänud käed rüppes ootama, vaid võtsid aktiivselt osa Eesti Vabariigi taastamisel.'], ['Tal olid käed rüppes.'], ['Mõnele meeldib käed rüppes istuda.']]
varem tehtuid - varemtehtuid - [['Meil tuleb arvestada sellega, et meie ei kordaks varemtehtuid vigu.']]
marionetid - marjonetid - [['Mõnikord tundub mulle, et inimesed on justkui marjonetid või mängukaardid, kellega mängitakse Suurt Mängu.']]
tegelikke - tegelike - [['Elu on hindamatu ning selles peitub kuhjaga tegelike ja näiliseid väärtusi.']]
elu - elut - [['Ta soovib oma lapsele paremat elut']]
kuritegu - kuridegu - [['Väga paljud teised, ei oleks suutnud nii ränka kuridegu andestada.']]
kahe tuhande - kahetuhande - [['Terroriakt Ameerikale, kus suri üle kahetuhande süütu inimese.'], ['Ta ilmub kahetuhande neljandalt korda staadionile.'], ['See juhtus kahetuhande üheksandal korral.'], ['aastast kahetuhande neljanda']]
läbi aegade - läbiaegade - [['Inimeste sugu on mõjutanud nende elu läbiaegade.'], ['Soorollid maailmas on läbiaegade olnud erinevad.']]
vähem tasustatud - vähemtasustatud - [['Seetõttu on neil ka tavaliselt vähemtasustatud töö.']]
ülesanded - ülessanded - [['Nende ülessanded ka koduses majapidamises on kergemad.']]
üldse - ültse - [['„Ah, vaheta teemat ja mis see patriotism ültse veel on?“.'], ['Mis ta sulle rääkinud ültse on?'], ['Miks nad inimesi ültse peavad sinna viima?']]
paar korda - paarkorda - [['Isamaalisi laule ja luulet lastakse ja kuulatakse paarkorda aastas, seda ka ainult riigipühadel.']]
jalge alt - jalgealt - [['Voltaire on öelnud: „Ükski lumehelves ei tunne ennast laviinis süüdi,“ samamoodi ei pruugi süüd tunda kodanik, kes on kodumaa tolmu jalgealt pühkinud ning laia maailma läinud.']]
väärtushinnangute kujunemisele - väärtushinnangutekujunemisele - [['Olen veendunud, et perekond avab inimese silmad kõige hea suhtes ja aitab kaasa indiviidi väärtushinnangutekujunemisele.']]
ühiskondlike - ühiskondlikke - [['Mida aeg edasi, seda aktiivsemalt on inimesed hakanud mõistma selle vajalikkust ning tahtma osa võtta ühiskondlikke küsimuste lahendamisest.']]
nimetatakse - nimetata-kse - [['Need on sellised inimesed, keda nimetata-kse halliks massiks.']]
unustatakse - unustata-kse - [['Karjääritegemise käigus unustata-kse inimese sisemaailm.']]
mõnel pool - mõnelpool - [['Kuid Eestis on mõnelpool arenenud isamaalisusest rahvuslus.']]
kahekümne esimese - kahekümneesimese - [['Teos „2001: Kosmoseodüsseia” räägib, kuidas inimesed on kahekümneesimese sajandi alguses loonud kosmosekolooniad.']]
Kaks kolmandikku - Kaks-kolmandikku - [['Kaks-kolmandikku meie riigipiirist on veepiir.']]
tohutu suur - tohutusuur - [['See tohutusuur tulekera oleks justkui merre vajunud ja siis kustunud.']]
ette määratud - ettemääratud - [['Öeldakse, et saatus on ettemääratud, kuid kas ikka on?']]
tegudeta - teguteta - [['Ei piisa vaid mõtetest, ilma teguteta ei muutu midagi.'], ['Olgu tegude tagajärjed kas head või halvad, kuid ilma teguteta ei saa ka oma saatust valida.']]
ellu viia - elluviia - [['Nii palju, kui on inimesi, sama palju on ka mõtteid, mida elluviia.']]
tegusid - tegusi - [['Kardetakse tegude tagajärgi, kuid see on hea, sest ei mõelda teha ainult häid tegusi.'], ['Aga samas on inimesi, kes on mõtteis tegusi teinud ja nendest tegudest saatust muutnud.'], ['Ning kui tuleb kellelgi idee, siis hakkavad nad selle idee järgi tegusi tegema.'], ['Olen isegi ajakirjandusest lugenud, et paljud noored on teinud oma tegusi ainult kavatsuste järgi.'], ['Ja on olnud ka selliseid tegusi, kus on keegi haiget saanud ning siis nad mõtlevad, et miks nii.'], ['Sest kuidas me teeme tegusi nõnda tuleb sellele ka saatus.']]
ette antud - etteantud - [['Muidugi on lihtsam valida „tee“, mis on kergem ja etteantud.']]
läbi mõeldud - läbimõeldud - [['Kui võetud risk firma asutada on piisavalt läbimõeldud ning tehtud turu-uuring, on tunduvalt tõenäolisem, et asutust hakkab saatma edu.'], ['Kaalutletud ideed on läbimõeldud ning saavad enamjaolt tegudeks.']]
meeste vahel - meestevahel - [['Sellest algasid meestevahel tülid.']]
tegelikkuseks - tegelikuseks - [['Nüüd on see mõte saanud tegelikuseks ja kuna seadus Euroopa Liidust väljaastumiseks puudub, on Eesti saatus selles liidus tegutseda.']]
praegu - pra-egu - [['Kindlasti oli see otsus õige, kuna juba pra-egu on Eesti majandus tänu abirahadele ja neide mõistlikule kasutamisele hoogustunud.']]
mis tahes - mistahes - [['Näiteks kodanikul tekkis hea äriidee, selleks võib olla mistahes eluvaldkond.']]
Tahest tahtmata - Tahestahtmata - [['Tahestahtmata kahjustame oma plaanide ja mõtetega nii mõndagi.']]
maailma riigid - maailmariigid - [['Ma olen näinud televiisorist kui milliseid torme teised maailmariigid peavad üle elama, sest neil on need vahetpidamata.']]
igal pool - igaplool - [['Eestis ja ka igaplool maailma eri paikades tegeletakse väga palju spordiga.']]
ette nähtud - ettenähtud - [['Inimestel on ettenähtud prügi liigitada ja selleks on ka erinevad prügikonteinerid.']]
usklikkusega - usklikusega - [['Tugevat negatiivset vastukaja lugejatelt sai näitleja Mel Gibson, kes umbes kümne aasta eest tuli välja oma tohutu usklikusega.']]
õppima - õpima - [['Iga hommik ärka üles, mine kas kooli õpima, et saada endale haridust, või mine tööle, et raha teenida ja paremini elada.'], ['Ta hakkas õpima TTÜs.'], ['Ma hakkasin õpima Tallinnas.']]
tekitab - tekkitab - [['Mis tekkitab meis endas seda rahulolematust oma elu suhtes?'], ['See pool tekkitab palju tossu.'], ['Mulle tekkitab ta tööd juurde.'], ['See tekkitab musta tossu.'], ['See tekkitab palju küsimusi.']]
iga päev - igapäev - [['Seetõttu on tihti noorte jaoks nende enda kodu nagu vangla, kus nad peavad igapäev olema.']]
leppida - lepida - [['Kuid kõiki asju ei saa alati paremaks teha, siis tuleb sellega lepida.'], ['Kas me saaksime kokku lepida mõned vestlused?']]
leidke - leidge - [['Kui teil on asju, mis teile enda rahulolematust tekitavad, siis proovige neid parandada või leidge nendes asjades midagi positiivset.']]
kasutamata - kasutamatta - [['Meil on võimalusi tohutult ning oleks rumal jätta need kasutamatta.']]
mere äärde - mereäärde - [['Inimesed püüdlevad rohkem kui kunagi varem asuma elama mereäärde.']]
nii palju - niipalju - [['Meil on veel niipalju looduslikku rannaala ja selle muutmine kõigile avatuks looduskaitsealaks, muudaks Eesti eriti heaks näiteks maailmas.']]
samuti - sammuti - [['Majanduslik seis räägib sammuti nende kasuks.'], ['Iga päev on võimalik minna Tallinnast Helsingisse, sammuti on Tallinnast võimalik minna ka Stockholmi.'], ['Nende juured on ju seal ja sünnikoht sammuti.'], ['Nemad on sammuti rahvuslased.']]
Iga kord - Igakord - [['Igakord ei pruugi inimesel oma tegudega saatust muuta nagu ta on unistanud.'], ['Igakord, kui tuli uus võõrvõim, jäid eestlased ikkagi truuks oma isamaa armastusele.']]
igal pool - igalpool - [['Tal on igalpool idee, millest ta unistab.'], ['Erinevatel maadel on küll erinevad tavad ja kombed, kuid teise indiviidi vara omandamist peetakse igalpool varguseks.']]
mõtetes - mõttetes - [['Alati mõttetes sünnib tegu, tegudest saatus.'], ['On oma mõttetes.'], ['Kas sa kujutad mõttetes midagi?']]
keskkonda - keskonda - [['Kes lahkub tavaliseks muutunud kodukohast uude keskonda, kes läheb lihtsalt korraks eemale, et kodukohta uute teadmistega rikastada.'], ['Ei tohi rikkuda keskonda kaitsvaid seadusi.'], ['Paljude keskonda puutuvate küsimustega tuleb minu poole pöörduda.']]
sisse võetud - sissevõetud - [['Samuti on temast sissevõetud pansionaadiproua.']]
soliidselt - soliitselt - [['Kui sa tahad endale korraliku kodutunde luua, siis sul peab olema kõvasti teravust ja soliitselt raha.']]
tähele pannud - tähelepannud - [['Olen tähelepannud, et Eestis on rohkem valla või maakonna siseseid algatusi võrreldes riigi tasandil olevatega.']]
kaasa arvatud - kaasaarvatud - [['Paljud Euroopa Liidu liikmesriigid, kaasaarvatud Eesti, võtsid oma kohustuseks aitamise ning andsid Kreekale raha.']]
hulga - hulka - [['Eesmärgiks on nälga tundvate inimeste hulka vähendamine.']]
kodu sisustamisega - kodusistumisega - [['Oli teada, et tervet aastat kodusistumisega mööda saata ja järgmisel aastal uuesti proovima minna oli mõtetu.']]
Teisest küljest - Teisestküljest - [['Teisestküljest ei lähe ükski inimene ka tööd otsima, kui tal endasse usku pole.']]
uuesti proovimisel - uuestiproovimisel - [['Kas uuestiproovimisel on üldse mõtet?']]
välja kasvanud - väljakasvanud - [['Ühenduse funktsiooniks oli kaitsta küla vallutajate eest, kuid tänaseks on sellest väljakasvanud organiseeritud kuritegevuse kõrgeim vorm.']]
nii väike - niiväike - [['Kas tõesti on armastus kodumaa vastu niiväike või peitub see põhjus kusagil mujal?']]
unustama - unu-stama - [['Mil muul moel olekski tal võimalust oma mainet puhtaks pesta, sest rahvas ei kipu halbu uudiseid unu-stama.']]
kaks korda - kakskorda - [['Välismaal pakutakse sama töö eest vähemalt kakskorda suuremat sissetulekut kui Eestis.']]
kolm korda - kolmkorda - [['Soomes on keskmine palk kolmkorda suurem kui Eestis, lisaks veel erinevad toetused, mida riik maksab.']]
ühiskondlikke - ühiskondlike - [['Algatatud on ühiskondlike liikumisi, mis on suunatud ühisele heaolule.']]
koolis käima - kooliskäima - [['Seega peavad inimesed kooliskäima, et saada targaks.']]
mitte kunagi - mittekunagi - [['Nii keerleb üks mittekunagi seisma jääv ring.']]
talu rajada - talurajada - [['Tema tahtis endale talurajada ja ta sai sellega ka hakkama, kuigi oli tagasilööke ning ebaõnnestumist.']]
teisedki - teisedgi - [['Tema järel tulid teisedgi ning rajasid sinna oma kodud.']]
edasi võidelda - edasivõidelda - [['Tagasilöögile ei tohi järgneda allaandmist, tuleb edasivõidelda võiduka lõpuni, sest homme on ka päev, mis tahab elamist ning hästi elamist.']]
toime pandud - toimepandud - [['See polnud esimene juhus kui koolis oli toimepandud kuritegu.']]
edasi pürgida - edasipürgida - [['Juhuse hooleks ei tohi midagi jätta, peab olema eneseusku ja tahtejõudu edasipürgida.']]
ülesandeks - ülesanndeks - [['Naise ülesanndeks oli kodu korras hoida.']]
tükk aega - tükkaega - [['Roll, et mees on see, kes raha toob on juba tükkaega tagasi välja juuritud.']]
kõike - kõikke - [['Võrdõiguslikud liikumised proovivad ja ka teevad kõikke selle heaks, et naine ja mees oleksid võrdsed kõiges ja kõigi ees.']]
leti taga - letitaga - [['Mulle meeldiks naist näha eelkõige kuskil letitaga või juukseid lõikamas, kui õlise mehaaniku või hoopis kaevurina.']]
ette sidunud - ettesidunud - [['Nüüdseks on üha rohkem mehi ettesidunud põlle ja pähe tõmmanud kokamütsi, ja õigustatult.']]
kaotaksime - kaota-ksime - [['Sellest ei võidaks me midagi, vaid pigem kaota-ksime suure osa kultuurist.']]
mere ääres - mereääres - [['Suurem osa Eesti riigist on ümbritsetud merega ning mereääres asub ka eestlaste pealinn.'], ['Juhime paati mereääres.'], ['Seal mereääres ta ongi.'], ['Ma jalutasin mereääres.'], ['See on kuskil mereääres.']]
drastilisi - trastilisi - [['Palju näiteid võiks tuua inimestest, kelle elu on muutunud pärast trastilisi juhtumisi nende elus.']]
kokku puutunud - kokkupuutunud - [['Ka mina olen lastekodulastega kokkupuutunud ning olnud vabatahtlikuks nende abistamisel.']]
saatuse tahtel - saatusetahtel - [['Mõnikord on inimene sunnitud saatusetahtel oma kodust lahkuma.']]
läbi saada - läbisaada - [['Järelikult tuleks proovida paremini läbisaada ning lubada ka natuke rohkem vabadust.']]
kümne - kümmne - [['Selle kümmne aasta jooksul tehtud teod on taganud meile õnneliku saatuse.']]
poolteist - pooldeist - [['Fotokunst täiendab tänapäeva umbes pooldeist sajandit.']]
loomingulisel teel - loominguliselteel - [['Iga pilt on kunstniku mõte, mida ta annab edasi loominguliselteel.']]
kunstnikke - kunstnike - [['Inimesed on õppinud hindama nii kunsti, kui ka kunstnike.']]
toime tulla - toimetulla - [['Samas, igal rahvusel võimalus Eestis ja mujal maailmas edukalt toimetulla, on vaja ainult käed tolmuseks teha!']]
teineteist - teineteis - [['On ka rahvaid kes mõistavad teineteis ja nende koostöö sujub.']]
mõne hetkega  - mõnehetkega - [['Ajalugu näitab, et tegelikult rahvusvahelised lepped võivad muutuda vaid mõnehetkega!']]
rassism - rasism - [['Selleks et maailmas kaoks häda ja viletsus, ning igasugune rasism ja massivaen peaks kogu maailm palju koostööd edendama.']]
enda jaoks - endajaoks - [['Praegu saab iga inimene anda endast parim, et luua endajaoks soovitud elu.']]
tema jaoks - temajaoks - [['Mõni inimene võib tunda, et kodu on temajaoks justkui piir, mis ei lase tal end teostada.']]
seal veedetud - sealveedetud - [['Alati saab ju paremini, aga sealveedetud aastad jäid talle meelde.']]
välja pakkuda - väljapakkuda - [['Teletöötajatel peab pidevalt olema väljapakkuda uusi saateid ja seriaale, mis inimesi köidaks.']]
välja tuua - väljatuua - [['Veel võiks väljatuua meie noored, lõpetavad gümnaasiumi, edasi ülikooli, aga peale ülikooli on kõik jälle lahtine.']]
ühe koha - ühekoha - [['Tegelikult ei ole mõtet ühekoha peal tammuda ja ennast haletseda, et kõik on pahasti.']]
kokku võtta - kokkuvõtta - [['Tuleb maha istuda ja ennast kokkuvõtta.']]
käe peale - käepeale - [['Inimesed on rahul ainult siis, kui neile raha käepeale koguaeg tekiks.']]
rahaprobleemid - raha probleemid - [['Enamustest inimestest lahkuvad kodudest, sest neil on raha probleemid või mingid teised probleemid, lihtsalt põgenetakse probleemidest.']]
näidanud - näitanud - [['Heal juhul saab maksta maksud, kuid oma lõbudeks raha enam ei jätku.']]
transpordi - trantsporti - [['Peavad otsustama, kas nende teenitud raha läheb ainult trantsporti peale.']]
tänapäeval - täna-päeval - [['Ka täna-päeval lähevad noored kaugemale õppima.']]
Vahetevahel - Vahete vahel - [['Vahete vahel luuakse ka oma pered kaugel õppides.']]
vaadates - vaatates - [['Vaatates Eesti noori lauljaid, kes suudavad end kaugel ka läbi lüüa.']]
Sattudes - Satudes - [['Satudes juhuslikult ühte laagrisse otsustasid nad vahetada kohad nii, et nad saaksid tundma õppida ka teist vanemat.']]
noorte - noorde - [['Me võiks küsida nende noorde käest, miks nad lahkuvad.']]
plagiaadisüüdistusi - plagiaadi süüdistusi - [['Meediast käib läbi plagiaadi süüdistusi, laulmisel ja riietumisel tehtud vead või hoopiski lauluoskamatus.']]
tahest tahtmatult - tahestahtmatult - [['Meedia loob tahestahtmatult inimesest kuvandi.']]
ise tekkima - isetekkima - [['Kui inimene on haritud ja avatud ning meedia tahab teda nendest külgedest esitleda, on hea kuvand isetekkima.']]
üles astutakse -  ülesastutakse - [['Suurt kasu toovad ka oskused ja näiteks saate valik, kus ülesastutakse.']]
jätkusuutlikkuse - jätkusuutlikuse - [['Uute kogemuste omandamine on hädavajalik jätkusuutlikuse tugevdamiseks.']]
maa peal - maapeal - [['Sellega saab luua kõva alusvundamendi iseseisvumiseks, ning kindlalt kahe jalaga maapeal olemiseks.'], ['Kui maapeal üheagselt olevad kuulsused']]
Sisemine heitlus - Sisemineheitlus - [['Sisemineheitlus hea ja kurja vahel on haripunktis siis, kui inimene peab oma vallatud ja süüdimatud mõtted vahetama küpse ja täiskasvanuliku mõttelaadi vastu.']]
ette karjuksid - ettekarjuksid - [['Pole vaja diktaatoreid ja türanne, kes meile ruuporist ettekarjuksid, mida öelda, mõelda või teha.']]
vastu hakata - vastuhakata - [['Näidates näpuga teistele, näitame iseenda nõrkust ja suutmatust probleemidele vastuhakata.']]
jumala staatusesse - jumalastaatusesse - [['Miljonite inimeste jaoks jumalastaatusesse tõusnud ning Windows-põlvkonnale igavese aluse pannud Bill Gates on geenius.']]
loodust vaatlema - loodustvaatlema - [['Austraaliasse minnakse aga eksootilist loodustvaatlema.']]
huvi äratab - huviäratab - [['Seal leidub erilisi taime- ja loomaliike, mis inimestes huviäratab.']]
metsast külla - metsastkülla - [['Andrus Kivirähu romaanis „Mees, kes teadis ussisõnu“ kolis Pärtel metsastkülla.']]
külaelu - küla elu - [['Nad vahetasid sooja ihu ja mugava eluviisi küla elu vastu, kus riietuseks olid õhukesed linariided ja tööks oli sügav põllutöö.']]
tihtipeale - tihti peale - [['Kodukohas sa tihti peale ei suuda omandada seda haridust, mida sa tegelikult sooviksid omandada.']]
miinimumplaga - miinimum palga - [['Inimesed muutuvad tihti rahulolematuks, kuna nad kardavad jääda töötuks, kuna ajalehed tihti kirjutavad artikleid, kuidas inimesed otsivad tööd kasvõi miinimum palga pealt ning see muudab inimese rahulolematuks.'], ['Noored peavad minema varakult tööle ning leppima miinimum palgaga ja ainult sellepärast, et vanematel puudus raha nooruki edasiõppima saatmiseks.']]
paari tuhande - paarituhande - [['Meie moraali alused on kirja pandud paarituhande aasta eest ja nende vanade seaduste järgi elame praegugi.']]
laiali laguneda - laialilaguneda - [['Kogu see võitlus vaid selle nimel, et lakata olemast ja lasta oma „moraalne aine“ laialilaguneda.']]
Jõukamate - Iõukamate - [['Iõukamate perekondade lastel on võimalik minna edasi õppima erakooli.']]
sissesaamiseks - sisse saamiseks - [['Muidugi on ka teisi häid koole aga neile on sisse saamiseks väga suur konkurents.']]
alkohol - alkohool - [['Elus on ka teisi piire nagu tubakas, alkohool, uimastid neile kõigile on seatud teatud piirid.'], ['sest alkohool on tevisele kahjulik']]
Alkoholiga - Alkohooliga - [['Alkohooliga on täpselt sama lugu.']]
alkoholi - alkohooli - [['Kuigi on piiratud alkohooli müük teatud eluaastani saavad lapsed seda ikka kätte.'], ['Tuli ta tööle alkohooli joobetunnustega.']]
poemüüjad - poemüüijad - [['Selles on süüdi poemüüijad kes ei vaata kellele nad müüvad.']]
surnukuuris - surnu kuuris - [['Tavaliselt lõppeb narkomaani elu kas kiirabis või surnu kuuris.']]
töötanud - töödanud - [['Aga kust ma peaksin need kogemused saama, kui ma pole enne sel tööl töödanud.']]
ette võtta - ettevõtta - [['Nii palju aega võiks ikka kõik leida, et õhtuti väike tervislik sörkjooks või vähemalt jalutuskäik ettevõtta.'], ['Midagi tuleb ettevõtta.'], ['Selle näiteks võib ettevõtta liikluse.']]
igapäevaelu - igapäeva elu - [ ['Lihtsportlane elab oma tavalist igapäeva elu.'], ['Loodud internetiteenused nagu e-post ja internetipank võimaldavad igapäeva elu mugavamalt ja odavamalt korraldada.']]
proffidel - profidel - [['Seevastu profidel on hoopis raskem.']]
omaealiste - oma ealiste - [['Noore naise ainsaks unistuseks on lahkuda mägedest ja elada oma ealiste keskel.']]
hakates - hakades - [['Naine lahkub oma võõrustaja juurest, hakades käima Clerfaytiga kaasas võistlustel.']]
ülejäänud - üle jäänud - [['Kuid mees armastab naist nii palju, et tahab lõpetada võidusõitmise ning pühendada üle jäänud elu perekonna loomisele.']]
hamba alla - hambaalla - [['Ja kohe meenuvad mulle lapsed, kellel ei ole leiba, mida hambaalla pista.']]
kahe käega - kahekäega - [['Lausa kurb on vaadata vanainimesi, kes hoiavad kahekäega kinni leivapätsist, mille ostavad, ja korjavad üles iga sendi, mis leiavad.']]
ohu piiril - ohupiiril - [['Inimene kas tegutseb teadlikult, vahel mitte, ohupiiril.']]
mistahes - mis tahes - [['Alati enne suurt aega toimuvad väikesed sündmused, mis tahes tahtmata viivad suuremate sündmuste juurde.']]
juhioskusi - juhi oskusi - [['Kõik need inimesed on väga suured inimesed, kes oskavad inimesi juhtida ja nad ka näitasid oma juhi oskusi „Laulva revolutsiooni“ ajal.']]
poliitikuoskusi - poliitiku oskusi - [['Sellel ajal nad ka näitasid oma poliitiku oskusi.']]
kättevõtmise - kätte võtmise - [['Igal pool on võimalik ennast teostada, see on puhtalt kätte võtmise asi.']]
kuudepikkuseid - kuude pikkuseid - [['Peale kuude pikkuseid kannatusi sai seitsmik viimaks vabaks ning üle meeletult pika aja oma kodudes ootavate peredega kontakteeruda.']]
liikmesriikide - liikmes riikide - [['See tähendab, et kõikide liikmes riikide kodanikel on võimalus asuda elama ja ringi liikuda teistes Euroopa Liidu riikides.']]
maailmamajandus - maailma majandus - [['Ühtne maailma majandus lubaks näiteks väga ökonoomselt tarvitada maavarasid ning luua piirid saastatusele']]
vastu tahtmist - vastutahtmist - [['Elu muutus lapsega peab olema rõõmus hetk, sest muidu oleks laps vastutahtmist.']]
tekib - tekkib - [['Tarkuse raamat tekkib igaühele aja jooksul ise.']]
daatumitega - taatumitega - [['Võib olla ei jõua seda täitma hakata, siis pannakse sellele puhtale paberile lihtsalt nimi alla koos taatumitega.']]
aru saama - arusaama - [['Mis oligi kellegi elupõhimõte ja sellelgi on iva sees, millest peab igaüks ise arusaama.']]
mõtlevatele - mõttlevatele - [['Positiivselt mõttlevatele inimestele on see kergem kui teistele.']]
edusammu - edusamu - [['21. sajand toob endaga kaasa ka tehnika suure edusamu.']]
meelt lahutada - meeltlahutada - [['Üheks suurepäraseks võimaluseks oma meeltlahutada on läbi virtuaalmaailma.'], ['Kellele aga ei istu, või ei ole meeldiv viibida virtuaaljututubades, need otsivad endale teisi võimalusi oma meeltlahutada.']]
osa võtta - osavõtta - [['Läbi virtuaalmaailma saame osavõtta väga paljudest meelelahutusega kaasnevatest sündmustest ja samal ajal olla ise selle keskpunktis.'], ['Sellest võiks osavõtta meie.'], ['Ma tahan osavõtta sellel konkursil.']]
hea asjaga - heaasjaga - [['Küll aga siinkohal tahaks öelda, et virtuaalmaailm on kogunud palju plusspunkte aga iga heaasjaga käivad kaasas ka puudused.']]
nii kergelt - niikergelt - [['Virtuaalmaailm sarnaneb omamoodi hasartmänguga, et kui korra oled proovinud, siis sellest enam niikergelt lahti ei saa.']]
tänapäeval - täna päeval - [['Nagu ka teame, et täna päeval ei ole kättesaadav tasuta peaaegu midagi, siis ka virtuaalmaailma puhul tuleb selle teenuse eest maksta.']]
üldse vaja - üldsevaja - [['Nii, et ennem virtuaalmaailma soetamist tuleb läbi arvutada, et kas on seda üldsevaja.']]
pallimängualadel - pallimängu aladel - [['Sportlastel eriti pallimängu aladel on väga hästi näha kes oskab oma riigi hümni ja kes mitte.']]
ei ole - eiole - [['Sõjavägi eiole ainult füüsiline tugev ettevalmistus.']]
kolleege - koleege - [['Kogu süsteem on üles ehitatud sedasi, et peab usaldama oma koleege.']]
pika - pikka - [['Kuidas tuleb see tunne ja kui pikka aja jooksul ta tekib.']]
Sel juhul - Selljuhul - [['Selljuhul on iga riigi huvitavad iseärasused kadunud.']]
internetti - interneti - [['Kuid ei ole head ilma halvata: interneti võib kasutada leidmaks informatsiooni, mis pole mõeldud kõigile vaatamiseks ja teadmiseks.']]
Internetti - interneti - [['Interneti võib vaadelda, kui suurt virtuaalmaailma, mis ühendab rahvast üle kogu maakera.']]
Arvutimängud - Arvuti mängud - [['Arvuti mängud loovad inimesele samuti virtuaalmaailma.']]
korda saata - kordasaata - [['Teadmiste jõud on väga suure väega ja sellega saab mõjutada, muuta ja kordasaata vägitegusid.']]
saa - sa - [['Tavaliselt rahvas teab seda kuid ei sa seda parandada.'], ['Rahvas teab seda, kuid ei sa tihtilugu seda muuta.']]
tuua - tua - [['See ei pruugi kaasa tua midagi head.'], ['See võib tua soovimatuid tulemusi.'], ['Mul vaja tua kaasa enda kott.'], ['Kas ma saan selle Saksamaale tua?']]
meediakanalid - meedia kanalid - [['Üle suurema osatähtsusega rahva teadmistest ongi meedia kanalid nagu, televiisor, raadio ja internet.']]
aidata - aitata - [['Nende teadmistega saab rahvas üksteist aitata.']]
igla ühel - igalühel - [['Inimesi on erinevaid, igalühel on elus oma tee käia ja oma tõde otsida.']]
au sees - ausees - [['Vanavanemate isamaalisus seisnes selles, et kõik, mis oli seotud rahvussümboolikaga peeti kõrgel ausees.'], ['Anna aga hakkas oma armastuse eest võitlema ja kuna sel ajal ei olnud abielu lahutamine ausees, siis ta ei saanud oma mehelt lahutust.']]
Aja jooksul - Ajajooksul - [['Ajajooksul siinne põliselanikkond unustas, või siis salgas oma isamaalisuse, et mitte sattuda uue valitsuse pahameele alla.']]
onupojapoliitika - onupoja poliitika - [['Kõigil kolmel riigikorral on ometigi midagi sarnast, sellest on onupoja poliitika.']]
üheselt mõistetav - üheseltmõistetav - [['Jumal - nii üheseltmõistetav - kaitsja ja hoidja.']]
interneti punkte - internetipunkte - [['Vajadusel võimaldab riik kasutada ka tasuta internetipunkte.']]
saladuste - salatuste - [['Kuid sellele vaatamata on kunstnikud jõuetud maailma salatuste ees.']]
tuhmide - tuhmite - [['Need on kunstid, ühenduslülid hallide tuhmite pärlite jadas.']]
tundepagasis - tunde pagasis - [['Tema tunde pagasis käärib kurjuse jook, mis imeb jõuetuks inimarengu.']]
selle tõttu - selletõttu - [['Eks selletõttu arvutid nii populaarsed ongi.']]
õppimata - õppimatta - [['Hommikul tuleb aga õppimatta kooli minna, mis võib tuua kurbi tagajärgi.']]
tahakski - tahaksgi - [['Kuid kes meist üldse tahaksgi tulla tagasi reaalsusesse, kui juba kord võlumaailm on avastatud.']]
tegelikkusest - tegelikusest - [['Ka tundub, et kõik kes kord virtuaalmaailma kiiganud, jäävad sellest sõltuvusse, võib-olla sellepräast, et viimane ongi ju mõnes mõttes tegelikusest parem.']]
aja raiskamine - ajaraiskamine - [['Mis ütleb neile, et virtuaalmaailmas aega veeta, on ajaraiskamine, seda mina ei tea.'], ['Nagu öeldud, on virtuaalmaailm ajaraiskamine, mis viib mõtted pärismaailmast eemale.']]
tegelikkuses - tegelikuses - [['Kumba on virtuaalses tegelikuses rohkem, kas võlu või viletsust?'], ['Tuleks ikkagi elada tegelikuses, ja pühendada pikki tunde millegile praktilisele.'], ['Kas keegi teab kes ta tegelikuses on?']]
aru saanud - arusaanud - [['Ma pole siiani arusaanud, miks see nii on!']]
usu endasse - usuendasse - [['Selle raamatu peategelane Smoke on heaks eeskujuks inimestele, kes on kaotanud usuendasse ja eneseteostusse.']]
mitmekümne - mitme kümne - [['Kord jäi tal kokkulepe, et peab oma sugulastest kullaotsijatel varustuse üle mitme kümne miili pikkuse nõlvaku kanda.']]
ära hellitatud - ärahellitatud - [['Aga kuna ta oli ilma isata kasvanud ja ema poolt ärahellitatud, osutus see tal väga raskeks, vaevarikkaks ja pingeliseks teeks.']]
enda kohta - endakohta - [['Minu arvates oli Smoke õige karuliha sööja, nagu ta ise endakohta armastas öelda.']]
paaril korral - paarilkorral - [['Ta kaotas ainult paarilkorral usu endasse ja eneseteostusse.']]
ette võttis - ettevõttis - [['Ja kui ta juba midagi ettevõttis siis tegi ta selle ka lõpuni.']]
raamatutegelast - raamatu tegelast - [['Seda raamatu tegelast võiks võrrelda oma visaduse ja tahtejõuga meie presidendi L. Meriga.']]
tema juures - temajuures - [['Mind hämmastab temajuures see, et need rännakud ja filmid on ta teinud kõik täiesti üksi.'], ['Veel köidavad mind temajuures need kõned, mis on väga hästi koostatud.']]
kooli kõrvalt - koolikõrvalt - [['Rahaprobleem ei kummita mitte ainult lapsevanemaid, vaid ka noori tudengeid, kes selleks, et ära elada peavad käima koolikõrvalt tööl.']]
mahavõtmiseks - maha võtmiseks - [['Hetk puhkamiseks, endasse vaatamiseks, aja maha võtmiseks, enese analüüsimiseks.']]
kasulikku - kasuliku - [['Inimesed on loodud maailma üldjuhul selleks, et midagi kasuliku korda saata.']]
Jumala poolt - Jumalapoolt - [['Jumalapoolt kingitud aruga peame hakkama saama oma igapäeva toimingutega.']]
läbi lüüa - läbilüüa - [['Raske oleks edukalt läbilüüa selles kiiresti arenevas ühiskonnas, kui meil puuduksid erinevad kehaosad.']]
läitumisstiile - käitumis stiile - [['Neid käitumis stiile läheb vaja terve elu.']]
aru saada - arusaada - [['Kõige olulisem siiski on iga persooni suutelisus mõelda ja arusaada.'], ['Tähtis on arusaada mida öeldu all mõeldakse'], ['Soovitakse paremini arusaada rahvakunstist.']]
linnulennult - linnu lennult - [['Kõigile meist pole jumal kinkinud sellist pead mis haarab iga sõna linnu lennult.']]
kaasa töötama - kaasatöötama - [['Selleks peab rohkem õppima, kuulama ja mõttes kaasatöötama.']]
kaaskodanikke - kaaskodanike - [['Suhtlemine siin maailmas on äärmiselt vajalik selleks, et mõista kaaskodanike.']]
meeskonnaringis - meeskonna ringis - [['Neile on määratud igaks päevaks ülesanded mis toimuvad meeskonna ringis.']]
kõige tähtsam - kõigetähtsam - [['Mina leian, et kõigetähtsam siin elus on perekond, kes sind armastab ja toetab rasketel aegadel.']]
mõttetu - mõtetu - [['Keegi ei taha olla mõtetu inimene, kelle võimeid ei hinnata.'], ['See on küll mõtetu.'], ['Issand kui mõtetu rahakulutus!']]
elu jooksul - elujooksul - [['Kõik inimesed on jumala lapsed, igale isikule on antud mingi ülesanne mis tuleb välja selgitada elujooksul.']]
selle poole - sellepoole - [['Kui oled seadnud eesmärgi siis on lihtsam sellepoole püüelda.']]
võrdsed - võrtsed - [['Nendes portaalides oleme kõik võrtsed.']]
raklaami ohvriteks - reklaamiohvriteks - [['Üha rohkem inimesi langeb reklaamiohvriteks.']]
just nimelt - justnimelt - [['Usun, et televisioon mõjutab kõige enam noori, justnimelt eelkooliealisi ja teismelisi.']]
ette kujutada - ettekujutada - [['Kui igal inimesel on oma kindel saatus, kas siis üldse saab ettekujutada tulevikku?']]
välja tõrjutud - väljatõrjutud - [['Annat, kui abielunaist, kes armus Vronskisse, ei oleks ühiskonnast väljatõrjutud.']]
sõjaväekoolis - sõjaväe koolis - [['Ta pidi käima vastu tahtmist sõjaväe koolis ja elama nii nagu ta isa soovis.']]
rahulolematus - rahul olematus - [['Inimeste sees peitub rahul olematus, mis annab tõuke lahkumiseks.']]
mingisugust - mingi sugust - [['Võib olla on vaja ka mingi sugust suur ja šokeerivat sündmust, mis aitaks kaasa patriotismi tõusule.']]
peaaegu - peagu - [['Küsitlused ja intervjuud näitasid, et peagu kõik küsitletud olid meie võistkonna poolt.']]
välja viskama - väljaviskama - [['Kuid peame oma peast väljaviskama mõtted, et oleme kõikvõimsad.']]
füüsilist jõudu - füüsilistjõudu - [['Tänapäeval on ka töid, mis ei nõua eriti füüsilistjõudu.']]
läbi käinud - läbikäinud - [['Sõjad on ühed suurimad saatustega mängijad ja sõjast läbikäinud inimesed ei ole enam kunagi endised.']]
jõudumööda - jõudu mööda - [['Ta saab kätte kogu oma vara, nii palju kui seda on, ning hakkab seda jõudu mööda raiskama.']]
vastastikused - vastastikkused - [['Tunded olid vastastikkused, aga segavaks asjaoluks nende suhtes sai mehe abielu.']]
uus maailm - uusmaailm - [['Virtuaalmaailm on omamoodi uusmaailm, kus kehtivad omad reeglid ja tavad.']]
usku endasse - uskudaendasse - [['Kõigil peaks olema uskudaendasse.']]
oma tegudesse - omategudesse - [['Inimesele on väga tähtis usk omategudesse.']]
Kokkuvõtteks - Kokkuvõteks - [['Kokkuvõteks tahan lisada, et meedia mõju inimese üle on niivõrd suur sellepärast, et see suudab suuri rahvamasse panna uskuma suuri valesid.'], ['Kokkuvõteks ütleksin ma, et nõustun öelduga.']]
aadress - aadres - [['Mis meie aadres on?']]
aadress - adress - [['See on minu uus adress.'], ['Tema adress on']]
meeldib - meldib - [['Mulle meldib see sari.'], ['Mulle meldib see.']]
Niimoodi - Niimodi - [['Niimodi see mulle sattuski.'], ['Niimodi ma töö jaoks õppisingi.']]
pakub - pakkub - [['Firma pakkub teile palgatõusu.'], ['Kindlustust pakkub mitu erinevat firmat.'], ['Ta alati pakkub meile ka suitsuvorsti.']]
pakume - pakkume - [['Me pakkume teile kõige paremat pakketti.'], ['Me pakkume kõik lisad kohe kaasa.']]
rääkida - räägida - [['Võite vabalt kõigest räägida.'], ['Oskan räägida võõrkeeles.'], ['Sooviksin osata metsaloomadega räägida.'], ['Mulle meeldib räägida oma hobidest.']]
siis - sis - [['Haridus tuleb ka sis kasuks.'], ['Meid on sis rohkem.']]
sobib - soobib - [['Ma arvan, et parem soobib teile.'], ['See soobib rohkem inimestele.'], ['Tsentraalküte soobib sellele korterile.'], ['Siis soobib pakkumine.']]
sõpradega - sõbradega - [['Olin oma sõbradega väljas.'], ['Ta tegi trenni koos sõbradega.']]
tööd - tööt - [['Sain tööt sealt.'], ['Ma otsin uut tööt.'], ['Seda tööt on vaja teha.']]
õppida - õpida - [['Seda on vaja õpida.'], ['Kas te soovite õpida?'], ['Sain õpida just siis kui soovisin.']]
õppisin - õpisin - [['Ma õpisin koolis hästi.'], ['Ma õpisin grammatikat.']]
õpin - õppin - [['Ma õppin Tartus.'], ['Ma õppin uut keelt.'], ['Ma õppin kontrolltöö jaoks.']]